0000000000
0011a11110
0010000010
0210000030
0010000010
0011b11110
0000000000
