00000000000
0011a111100
00100000100
02100000130
00100000100
0011b111100
00000000000
