00000000000000000000000
0000b110111000011101110
00111011101110110111010
02100000000011100001010
00100000000000000001130
00100000000111111001010
00111000a11100001111010
00001111100000000001110
00000000000000000000000
