0000000000000000000000
0000011100111000000000
0011110111b01101110000
0010000000000111011100
0010000001110000000130
0010111001010111011100
021110a001010101010000
0000001111011101110000
0000000000000000000000
