00000000000000000000000
00000000011100111001110
001111011101b1101111010
00100111000000000001010
00100000011100111001130
00100000010101101001010
01111011a10101001111010
02001110000111000001110
00000000000000000000000
