00000000000000000000000
00001110111000011101110
00111011101110110111010
00b00000000011100001010
00100000000000000001130
02101110011101111001010
00111011110101001111010
00000000000a11000001110
00000000000000000000000
