00000000000000000000000
0000011b000000000001110
00111101111111101111010
00100000000000111001010
00100000011100000001130
00101a10010101111001010
01111011110101001111010
02000000000111000001110
00000000000000000000000
