000000000000000000000000
000000000000000000001110
000111111111111111111010
000100000000000000001010
000101111111111111101010
000b01000000000000101130
000101111111111111101010
021100000000000010001010
000111111a11111111111010
000000000000000000001110
000000000000000000000000
