000000000000000000000000
000000000000000000001110
0001a1111111111111115010
011100000000000001001010
020101111111111111101010
000101000000000000101130
000101111111111111101010
000100000000000000001010
000111b11111111111111010
000000000000000000001110
000000000000000000000000
