000000000000000000000000
000000000000000000001110
000b11111111111111111010
000100000000000000001010
000101111111111111101010
000101000000000000101130
000101111111111111101010
021100000000000001001010
00011111a111111111111010
000000000000000000001110
000000000000000000000000
