00000000000000000000000
00000000000000000001110
0011b111111111111111010
00100000000000000001010
00101111111111111101010
00101000000000000101130
00101111111111111101010
02100000000000010001010
00111111a11111111111010
00000000000000000001110
00000000000000000000000
