00000000000000000000000
00000000000000000001110
00111111111111111111010
00b00000000000000001010
00101111111111111101010
00101000000000000101130
02101111111111111101010
00100000000000001001010
00111a11111111111111010
00000000000000000001110
00000000000000000000000
