0000000000000000000000000
0011100000000000000111110
0010111111A11111111100010
0211100000000000000131110
0010111111a11111111100010
0011100000000000000111110
0000000000000000000000000
