00000000000000000000000000
00111100000000000000111110
0010011111111a111111100010
02111100000000000000131110
0010011111111A111111100010
00111100000000000000111110
00000000000000000000000000
