0000000000000000000000000
0011111111A11111111111110
0010100000000000000100010
0211100000000000000131110
0010100000000000000100010
0011111111a11111111111110
0000000000000000000000000
