00000000000000000000000000
0011111111111a111111111110
00100100000000000000100010
02111100000000000000131110
00100100000000000000100010
0011111111111A111111111110
00000000000000000000000000
