0000000000000000000000000000
000001111b111111000000000000
0000010000000001000000000000
0000010111011101000115111110
0000010101010101111501000010
0000010101010100000101000010
0011110101010101110101000010
0010011101a10111011101000010
0211110000000000000111311110
0010011101A10111011101000010
0011110101010101110101000010
0000010101010100000101000010
0000010101010101111501000010
0000010111011101000115111110
0000010000000001000000000000
000001111B111111000000000000
0000000000000000000000000000
