000000000000000000000000000
0000B1111111111000000000000
000010000000001000000000000
000010111011101111511111110
000010A01010100000101000010
001110101010101110101000010
001011101110111011101000010
021110000000000000111311110
001011101110111011101000010
001110101010101110101000010
000010a01010100000101000010
000010111011101111511111110
000010000000001000000000000
0000b1111111111000000000000
000000000000000000000000000
