0000000000000000000000000000
00001111b1111110000000000000
0000100000000010001151111110
0000101110111011115010000010
0000101010101000001010000010
0011101010101011101010000010
001011101a101110111010000010
0211100000000000001111311110
001011101A101110111010000010
0011101010101011101010000010
0000101010101000001010000010
0000101110111011115010000010
0000100000000010001151111110
00001111B1111110000000000000
0000000000000000000000000000
