0000000000000000000000000000
0000111B11111110000000000000
0000100000000010001151111110
0000101110111011115010000010
0000101010101000001010000010
0011101010A01011101010000010
0010111011101110111010000010
0211100000000000001111311110
0010111011101110111010000010
0011101010a01011101010000010
0000101010101000001010000010
0000101110111011115010000010
0000100000000010001151111110
0000111b11111110000000000000
0000000000000000000000000000
